#
# 0 D room1.txt 2
#
WWWW0WWWWW
W        W
W  S     W
WWWWWaaaaW
W   W    W
W   W  WWW
W  H     W
W        W
W        W
WWWWWWWWWW
